1111111111111111111111111111111111111111111111111111111111111111111111111111111111111111111111111
1111111111111111111111111111111111111111111111111111111111111111111111111111111111111111111111111
1111111111111111111111111111111111111111111111111111111111111111111111111111111111111111111111111
0000000000000000000000002200000000000000000000000000000000000000000000000000000000000000000000011
0000000000000000000000002200000000000000000000000000000000000000000000000000000000000000000000011
1111111111111111111001111111111111111111111111111111111111111111111111111111111111111111110000011
1111111111111111111331111111111111111111111111111111111111111111111111111111111111111111110040011
1111111111111111111331111111111111111111111111111111111111111111111111111111111111111111110000011
1111111111111111111331111111111111111111111111111111111111111111111111111111111111111111110000011
1111111111111111111331111111111111111111111111111111111111111111111111111111111111111111110000111
1111111111111111111331111111111111111111111111111111111111111111111111111111111111111111110000011
1111111111111111111331111111111111111111111111111111111111111111111111111111111111111111110000011
1111111111111111111001111111111111111111111111111111111111111111111111111111111111111111110010011
1111111111111111111001111111111111111111111111110000001111111000000000000000000000000000000000011
1111111111111111111001111111111111111000000000000000000000000000000000000000000000000000000000011
1111111111111111111001111111111111111000000000000022000000000111111111111111111111111111111111111
1111111111111111111001111111111111110000111116611122111111111111111111111111111111111111111111111
1111111111111111111000000000000000000000111116611122111111111111111111111111111111111111111111111
1111111111111111111000000000000000000011111116611111111111111111111111111111111111111111111111111
1111111111111111111111111111111111111111111111111111111111111111111111111111111111111111111111111
1111111111111111111111111111111111111111111111111111111111111111111111111111111111111111111111111