00000000000011111111111111111111111111111111111
00000000000011100000000000000000000000000000001
00000000000011100001111000011110000011111111111
00000000000000000008800000000000000000000000000
00000000000000000008800000000000000000000000400
00000000000000000008800000000000000000000000000
00000000000011188111111116611110000111111111111
00000000000011188111100016610000000000000000000
00000000000011188111100011110000000000000000000
00000000000011188111100000000000000000000000000
00000000000011111111100000000000000000000000000
00000000000011100000000000000000000000000000000
00000000000011100000000000000000000000000000000
00000000000011100000000000000000000000000000000
00111111111111100000000000000000000000000000000
00000000000000000000000000000000000000000000000
00000000000000000000000000000000000000000000000
00000000000000000000000000000000000000000000000
00000000000000000000000000000000000000000000000
00000000000000000000000000000000000000000000000
00000000000000000000000000000000000000000000000
00000000000000000000000000000000000000000000000
00000000000000000000000000000000000000000000000
00000000000000000000000000000000000000000000000
00000000000000000000000000000000000000000000000
00000000000000000000000000000000000000000000000
00000000000000000000000000000000000000000000000
00000000000000000000000000000000000000000000000