00000000000000000000000000000000000000000000000
00000000000000000000000000000000000000000000000
00000000000000000000000000000000000000000000000
00000000000000000000000000000000000000000000000
00000000000000000000000000000000000000000000000
00000000000000000000000000000000000000000000000
00000000000000000000000000000000000000000000000
00000000000000000000000000000000000000000000000
00000000000000000000000000000000000000000000000
00000000000000000000000000000000000000000000000
00000000000000000000000000000000000000000000000
00111111110001111112222222211111331155116611411
00000000000000000012222222210001331155116611100
00000000000000000012222222210001111155116610000
00000000000000000012222222210001111155116610000
00000000000000000011111111110001111111111110000